################################
#P......#.....................##
#.#######.###############.##.###
#.#.......................#..###
#.#.###############.#######.####
#.#.#...............#.......####
#.#.#.###########.###.#####.####
#.#.#.#.........#.#.....#...####
#.#.#.#.#######.#.#####.#.#.####
#.#.#.#.....#...#.....#...#.####
#.#.#####.#.#.#######.#####.####
#.#.......#.#...............####
#.#########.###############.####
#.........................#.####
###############.#########.#.####
#...............#.......#.#.####
#.###############.###.#.#.#.####
#.................#...#...#.####
#.###############.#.#######.####
#.................#.........####
#.#########################E####
################################
################################
