###############################
#P.................#..........#
#..####............#..........#
#..#..#............#..........#
#..#..#............#..........#
#..####............#..........#
#..................#..........#
#######..############........###
#..................#..........#
#..................#.......I..#
#..###########.....#..........#
#..#.........#.....#..........#
#..#...I.....#.....#..........#
#..#.........#................#
#..###########................#
#.............................#
#............######...........##
#............#....#...........##
#............#....#...........##
#............######...........##
#...........................E.##
#.............................##
################################
