.########.#####...#.......#####
.#...#..#.#...#...#.......#...#
.#...#..#.#.#.#...#########.E.#
.#...#..#.#.#.#...#...........#
.#...##.#.#.#.#...###.#########
##....#.#.#.#.#...#.#.#.......#
#.....#.#.#.#.#...#.#.#.......#
#.....#.#.#.#.#####.#.#.......#
#....##.#.#.#.......#.#.......#
##...#..#.#.#...#...#.#.......#
.#...######.#.#####.#.#.......#
.#..........#.#...#...........#
.#............................#
##..........#.#...#...........#
##..........#.#...#...........#
##..........#.#...#...........#
##....I.....#.#...#...........#
##..........#.#...#...........#
##..........#.#...#...........#
##..........#.#...#...........#
##..........#.#...#...........#
##..........#.#...#...........#
###############################
